0 0 0 0 0 0 0 0 0 0 0 0 0 0 0 0 0 0 0 0 0 0 0 0
0 0 0 0 0 0 0 0 0 0 3 3 3 0 4 4 4 4 0 0 0 0 0 0
0 0 0 0 0 0 0 10 10 0 3 3 3 0 4 4 4 4 0 1 1 1 1 1
0 0 0 0 0 0 0 10 10 0 0 14 0 0 0 14 14 0 0 1 1 1 1 1
0 0 0 0 0 0 0 10 10 14 6 6 6 0 1 1 1 1 1 1 1 1 1 1
8 8 8 0 0 0 0 0 0 0 6 6 6 0 1 1 1 1 1 1 1 1 1 1
8 8 8 0 13 13 13 0 0 0 6 6 6 0 1 1 1 1 1 1 1 1 1 1
8 8 8 0 13 13 13 0 0 0 14 0 0 0 1 1 1 1 1 1 1 1 1 1
8 8 8 0 13 13 13 0 7 7 7 7 7 0 1 1 1 1 1 1 1 1 1 1
8 8 8 0 13 13 13 0 7 7 7 7 7 14 1 1 1 1 1 1 1 1 1 1
8 8 8 14 13 13 13 0 7 7 7 7 7 14 1 1 1 1 1 1 1 1 1 1
8 8 8 14 13 13 13 14 7 7 7 7 7 0 1 1 1 1 1 1 1 1 1 1
8 8 8 0 13 13 13 14 7 7 7 7 7 0 1 1 1 1 1 1 1 1 1 1
8 8 8 0 13 13 13 0 7 7 7 7 7 0 1 1 1 1 1 1 1 1 1 1
8 8 8 0 0 14 0 0 0 14 0 0 0 0 0 0 0 14 0 0 0 0 0 0
8 8 8 0 11 11 11 0 9 9 9 0 5 5 5 14 12 12 12 0 2 2 2 0
8 8 8 0 11 11 11 0 9 9 9 0 5 5 5 0 12 12 12 14 2 2 2 0
0 0 0 0 0 0 0 0 0 0 0 0 0 0 0 0 0 0 0 0 0 0 0 0

